1111111111111111111111111
10011001C1111001101110111
1101110001100111101111111
110001011000E000001100111
100000000000P110100001011
1111111111111111111111111