1111111111111111111111111
1001100101111001101110111
1101110001100111101111111
110001011000E000001100111
10000C000000P110000001111
1111111111111111111111111