1111111111111
1E010C000C1C1
1P00000000111
1111111111111