11111111111111111111
10000000000000000001
1000001000000C000001
1P000000111000000001
10000000C00000000001
10000111110000000001
100000000000000000E1
11111111111111111111