11111111111
1P000C000E1
11111111111