11111111111111
1P0000111111C1
10000001111101
10110000010001
10101000C00001
1C111111111001
11111110CC00E1
11111111111111