1111111111111111111111111111111111
1111111111111111111111111111111111
1111111111111111111111111111111111
1111111111111111111111111111111111
1111111111111111111111111111111111
1111111111111111111111111111111111
1111111111111111111111111111111111
1111111111111111111111111111111111
1111111111111111111111111111111111
1P000000000000000000000000000000E1
1111111111111111111111111111111111
1111111111111111111111111111111111
1111111111111111111111111111111111
