11111111111111111111
10P00000CCC10000CCC1
1000001111110E011111
10000000000100001001
1E01111000010000E001
10000010000001E000E1
10CCC01000100100E001
100000100010010000X1
11111111111111111111