1111111111111111111111111
1P011011011110011C1110111
1101110001101111101111111
110001011000000000E110011
1011000000011111000000111
1111111111111111111111111