1111111111111111111111111
1P01111110111000001111C11
1101111101111111100011111
1100011110000E11111111111
1011000000011111000011111
1111111111111111111111111